Account Number,Transaction Date,Transaction Amount,Transaction Type,Transaction Description,Balance
1234,4/30/2023,10.85,Credit,Monthly Interest Paid,3941.52
1234,4/27/2023,100,Credit,Deposit from 360 Checking XXXXXXX5678,3930.67
1234,4/1/2023,200,Credit,Deposit from 360 Checking XXXXXXX5678,3830.67
1234,3/31/2023,10.29,Credit,Monthly Interest Paid,3630.67
1234,2/28/2023,8.79,Credit,Monthly Interest Paid,3620.38
1234,2/27/2023,200,Credit,Deposit from 360 Checking XXXXXXX5678,3611.59
1234,1/31/2023,8.88,Credit,Monthly Interest Paid,3411.59
1234,1/30/2023,200,Credit,Deposit from 360 Checking XXXXXXX5678,3402.71
